11111111
1P0001E1
1C000011
11111111