1111111111111111111
10000000C00000X0001
1001011111000001101
10010000C0000001101
1001000000000E01101
1P001111101100000C1
1111111111111111111